%%%%%%%%%
%.....o.%
%.%%o%%.%
%.%o..%.%
%G%.%.%.%
%.......%
%.%%%%%P%
%....o..%
%%%%%%%%%
%%%%%%%%%
