%%%%%%%%%
%%%%%%%%%
%.......%
%.%%%%%.%
%....o..%
%..%.%P.%
%.%%.%%.%
%.o%.%o.%
%%.G...%%
%%%%%%%%%
