%%%%%%%%%
%%.....%%
%G.%%%..%
%o%%%%%.%
%..o....%
%.%%%%%.%
%...%o.P%
%%%.%o%%%
%%%...%%%
%%%%%%%%%
