%%%%%%%%%
%G......%
%o%.%.%o%
%.%...%.%
%.%%%%%.%
%.....oP%
%.%%%%%.%
%....o..%
%%%%%%%%%
%%%%%%%%%
