%%%%%%%%%%%%%%%
%%%..o......%%%
%...%.%%%.%...%
%.%%%.%%%.%%%.%
%.....%%%.....%
%%.%%.....%%P%%
%%.%..%%%..%.%%
%%G%.%%%%%.%.%%
%%...oo......%%
%%%%%%%%%%%%%%%
