%%%%%%%%%%%%%%%%%%%%%
%%.................%%
%..%.%%.%%%%%.%%.%..%
%.%%.%...%.%...%.%%.%
%....%.%.....%.%....%
%%.%...%.%.%.%...%.%%
%%.%%.%%.%%%.%%.%%.%%
%........%.%..o.....%
%P%.%%.%.....%.%%.%o%
%.%....%.%%%.%....%.%
%.%%%.%%..%..%%.%%%G%
%...................%
%%%%%%%%%%%%%%%%%%%%%
