%%%%%%%%%%%%%%%%
%.....o%%......%
%G%%.%....%.%%.%
%..%.%%..%%.%..%
%........o.....%
%.%%%.%..%.%%%.%
%....o%..%.....%
%.%%%.%..%.%%%.%
%.o............%
%.%%.%%%%%%.%%.%
%.%..%....%..%.%
%......%%.....P%
%%%%%%%%%%%%%%%%