%%%%%%%%%%%%%%%
%%...%oP.%...%%
%..%...%...%..%
%.%%.%%%%%.%%.%
%..%.......%..%
%%...%%%%%...%%
%..%..%.%..%..%
%.%%%.....%%%.%
%.....%%%o....%
%.%%%.%.%.%%%.%
%.G.%.%.%o%...%
%%%.........%%%
%%%%%%%%%%%%%%%