%%%%%%%%%%%%%%%
%%...........%%
%%G%..%.%..%.%%
%%.%.%%%%%.%.%%
%%.%.......%o%%
%%...%%%%%.o.%%
%..%..%.%..%..%
%.%%%.....%%%P%
%.....%.%.oo..%
%.%%%.%.%.%%%.%
%..%..%.%..%..%
%%...........%%
%%%%%%%%%%%%%%%